e5b69b5837819b75df5ae7b8f90ce73a9c4620b4@382
/ \ / \ / \ / \ / \ / \ / \ / \ / \ / \ / \ / \ / \ / \ / \ / \
\ / \ / \ / \ / \ / \ / \ / \ / \ / \ / \ / \ / \ / \ / \ / \ /
/ \                                                         / \
\ /                                                         \ /
/ \                                 /~\                     / \
\ /                                |oo )                    \ /
/ \                                _\=/_                    / \
\ /                ___            /  _  \                   \ /
/ \               / ()\          //|/.\|\\                  / \
\ /             _|_____|_       ||  \_/  ||                 \ /
/ \            | | === | |      || |\ /| ||                 / \
\ /            |_|  O  |_|       # \_ _/ #                  \ /
/ \             ||  O  ||          | | |                    / \
\ /             ||__*__||          | | |                    \ /
/ \            |~ \___/ ~|         []|[]                    / \
\ /            /=\ /=\ /=\         | | |     Simon Jansen   \ /
/ \  __________[_]_[_]_[_]________/_]_[_\________________   / \
\ /                                                         \ /
/ \                                                         / \
\ /                                                         \ /
/ \ / \ / \ / \ / \ / \ / \ / \ / \ / \ / \ / \ / \ / \ / \ / \
\ / \ / \ / \ / \ / \ / \ / \ / \ / \ / \ / \ / \ / \ / \ / \ /
