b3279238c3c02eeaaa7e7b827013ff04454c60cb@37645
        _________
       [_________]
        |  .-.  |
        |,(o.o).|
        | >|n|< |
        |` `"` `|
        |POISON!|
jgs     `"""""""`
